00 00 00 00 00 00 00 00 00 00 00 00 00 00 00 00 00 00 00 00 00 00 00 00 00 00 00 00 00 00
00 00 00 00 00 00 00 00 00 00 00 00 00 00 00 00 00 00 00 00 00 00 00 00 00 00 00 00 00 00
00 00 00 00 00 00 00 00 00 00 00 00 00 00 00 00 00 00 00 00 00 00 00 00 00 00 00 00 00 00
00 00 00 00 00 00 00 00 00 00 00 00 00 00 00 00 00 00 00 00 00 00 00 00 00 00 00 00 00 00
00 00 00 00 00 00 00 00 00 00 00 00 00 00 00 00 00 00 00 00 00 00 00 00 00 00 00 00 00 00
00 00 00 00 00 00 00 00 00 00 00 00 00 00 00 00 00 00 00 00 00 00 00 00 00 00 00 00 00 00
00 00 00 00 00 00 00 00 00 00 00 00 00 00 00 00 00 00 00 00 00 00 00 00 13 00 00 00 00 00
00 00 00 00 00 00 00 00 00 00 00 00 00 00 00 00 00 00 00 00 00 00 10 11 11 11 11 11 12 00
00 00 00 00 00 00 00 00 00 00 00 00 00 00 00 00 00 10 12 00 00 00 00 00 00 14 00 00 00 00
00 00 00 00 00 00 00 00 00 00 00 00 00 10 12 00 00 00 00 00 00 00 00 00 00 14 00 00 00 00
00 00 00 00 00 00 00 00 00 10 12 00 00 00 00 00 00 00 00 00 00 00 00 00 00 14 00 00 00 00
01 02 02 02 02 02 03 00 00 00 00 00 00 00 00 00 00 00 00 14 14 14 14 14 14 14 00 00 00 00
04 05 05 05 05 05 06 00 00 00 00 00 00 00 00 00 00 00 00 00 00 00 00 00 00 00 00 00 00 00
07 08 08 08 08 08 09 00 00 00 00 00 00 00 00 00 00 00 00 00 00 00 00 00 00 00 00 00 00 00
04 05 05 05 05 05 00 00 00 00 00 00 00 00 00 00 00 00 00 00 00 00 00 00 00 00 00 00 00 00